..######..
#...#...#.
..#...#...
#...#...#.
..#.@.#...
#...#...#.
..#...#...
#...#...#.
..#...#...
#...#...#.
..######..